CCCWCCCCCC
CWCCCCCWWC
CCCWCCCCCC
CCCCCCCCCC
WCCCWWCCCW
WCCCCCCCCW
CWWCCCCCCC
CCTCCWCCWC
CCCCCWCCCW
CCWCCWCCWW