CCCCCCCCCW
WWWCCCWWCW
WCCCCCCWCW
WCWWWWCWCW
WCWCCCCWCW
WCWCTCCWCW
WCWCCCCWCW
WCWWWWWWCW
WCCCCCCCCW
WWWWWWWWWW