DDDDDDDDDW
WWWWWWWWDW
WDDDDDDWDW
WDWWWWDWDW
WDWDDWDWDW
WDWDDWDWDW
DDDDDDDDDD