DDDDDWWWWW
WWWWDDWWWW
WWWDDDDWWW
WWDDDDDDWW
WDDDDDDDDW
WDDDDDDDDW
WWDDDDDDWW
WWWDDDDWWW
WWWWDDWWWW
WWWWWWWWWW